Afganistan - Islamska Republika Afganistan
Albanija - Republika Albanija
Alzir - Alzirska Narodna Demokratska Republika
Andora - Knezevina Andora
Angola - Republika Angola
Antigva i Barbuda - Antigva i Barbuda
Argentina - Argentinska Republika
Armenija - Republika Armenija
Australija - Australija
Austrija - Republika Austrija
Azerbajdzan - Republika Azerbajdzan
Bahami - Zajednica Bahamâ
Bahrein - Kraljevina Bahrein
Banglades - Narodna Republika Banglades
Barbados - Barbados
Belarus - vidjeti Bjelarus
Belgija - Kraljevina Belgija
Belize - Belize
Benin - Republika Benin
Bjelarus - Republika Bjelarus
Bjelokosna Obala - vidjeti Côte d’Ivoire
Bjelorusija - vidjeti Belarus
Bocvana - Republika Bocvana
Bolivija - Visenacionalna Republika Bolivija
Bosna i Hercegovina - Bosna i Hercegovina
Brazil - Savezna Republika Brazil
Brunej - vidjeti Brunej Darussalam
Brunej Darussalam - Brunej Darussalam
Bugarska - Republika Bugarska
Burkina Faso - Burkina Faso
Burma - vidjeti Mjanmar
Burundi - Republika Burundi
Butan - Kraljevina Butan
Cipar - Republika Cipar
Côte d'Ivoire (poznatija kao Bjelokosna Obala ili Obala Bjelokosti)
Crna Gora - Crna Gora
cad - Republika cad
ceska - ceska Republika
cile - Republika cile
Danska - Kraljevina Danska
DNR Koreja - Demokratska Narodna Republika Koreja (Sjeverna Koreja)
DR Kongo - Demokratska Republika Kongo
Dominika - Zajednica Dominike
Dominikana - vidjeti Dominikanska Republika
Dominikanska Republika - Dominikanska Republika
dibuti - vidjeti Dzibuti
Dzibuti - Republika Dzibuti
Egipat - Arapska Republika Egipat
El Salvador - Republika El Salvador
Ekvador - Republika Ekvador
Ekvatorska Gvineja - Republika Ekvatorska Gvineja
Eritreja - Drzava Eritreja
Estonija - Republika Estonija
Etiopija - Savezna Demokratska Republika Etiopija
Fidzi - Republika Fidzi
Filipini - Republika Filipini
Finska - Republika Finska
Francuska - Francuska Republika
Gabon - Gabonska Republika
Gambija - Republika Gambija
Gana - Republika Gana
Grcka - Helenska Republika
Grenada - Grenada
Gruzija - Gruzija
Gvajana - Kooperativna Republika Gvajana
Gvatemala - Republika Gvatemala
Gvineja - Republika Gvineja
Gvineja Bisau - Republika Gvineja Bisau
Haiti - Republika Haiti
Honduras - Republika Honduras
Hrvatska - Republika Hrvatska
Indija - Republika Indija
Indonezija - Republika Indonezija
Irak - Republika Irak
Iran - Islamska Republika Iran
Irska - Irska
Island - Republika Island
Istocni Timor - vidjeti Timor-Leste
Italija - Talijanska Republika
Izrael - Drzava Izrael
Jamajka - Jamajka
Japan - Japan
Jemen - Republika Jemen
Jordan - Hasemitska Kraljevina Jordan
Juzna Afrika - Republika Juzna Afrika (poznatija kao Juznoafricka Republika)
Juzna Koreja - vidjeti Republika Koreja
Juzni Sudan - Republika Juzni Sudan
Juznoafricka Republika - vidjeti Juzna Afrika
Kabo Verde - Republika Kabo Verde (poznatija kao Zelenortska Republika)
Kambodza - Kraljevina Kambodza
Kamerun - Republika Kamerun
Kanada - Kanada
Katar - Drzava Katar
Kazahstan - Republika Kazahstan
Kazakstan - vidjeti Kazahstan
Kenija - Republika Kenija
Kina - Narodna Republika Kina
Kirgistan - Kirgiska Republika
Kiribati - Republika Kiribati
Kolumbija - Republika Kolumbija
Komori - Unija Komorâ
Kongo - vidjeti
Koreja - vidjeti
Kosovo - Republika Kosovo
Kostarika - Republika Kostarika
Kuba - Republika Kuba
Kuvajt - Drzava Kuvajt
Laos- Laoska Narodna Demokratska Republika
Latvija - Republika Latvija
Lesoto - Kraljevina Lesoto
Letonija - vidjeti Latvija
Libanon - Libanonska Republika
Liberija - Republika Liberija
Libija - Libija
Lihtenstajn - Knezevina Lihtenstajn
Litva - Republika Litva
Luksemburg - Veliko Vojvodstvo Luksemburg
Madagaskar - Republika Madagaskar
Madzarska - vidjeti Madarska
Madarska - Madarska
Makedonija - Republika Makedonija
Malavi - Republika Malavi
Maldivi - Republika Maldivi
Malezija - Malezija
Mali - Republika Mali
Malta - Republika Malta
Maroko - Kraljevina Maroko
Marsalovi Otoci - Republika Marsalovi Otoci
Mauricijus - Republika Mauricijus
Mauretanija - vidjeti Mauritanija
Mauritanija - Islamska Republika Mauritanija
Meksiko - Sjedinjene Meksicke Drzave
Mianma - vidjeti Mjanmar
Mianmar - vidjeti Mjanmar
Mijanmar - vidjeti Mjanmar
Mikronezija - Savezne Drzave Mikronezije
Mjanma - vidjeti Mjanmar
Mjanmar - Republika Unija Mjanmar (poznatija kao Burma)
Moldavija - vidjeti Moldova
Moldova - Republika Moldova
Monako - Knezevina Monako
Mongolija - Mongolija
Mozambik - Republika Mozambik
Namibija - Republika Namibija
Nauru - Republika Nauru
Nepal - Savezna Demokratska Republika Nepal
Niger - Republika Niger
Nigerija - Savezna Republika Nigerija
Nikaragva - Republika Nikaragva
Nizozemska - Kraljevina Nizozemska
Norveska - Kraljevina Norveska
Novi Zeland - Novi Zeland
Njemacka - Savezna Republika Njemacka
Oman - Sultanat Oman
Obala Bjelokosti - vidjeti Côte d’Ivoire
Pakistan - Islamska Republika Pakistan
Palau - Republika Palau
Panama - Republika Panama
Papua Nova Gvineja - Nezavisna Drzava Papua Nova Gvineja
Paragvaj - Republika Paragvaj
Peru - Republika Peru
Poljska - Republika Poljska
Portugal - Portugalska Republika
Republika Kongo - Republika Kongo
Republika Koreja - Republika Koreja (Juzna Koreja)
Ruanda - Republika Ruanda
Rumunjska - Rumunjska
Rusija - vidjeti Ruska Federacija
Ruska Federacija - Ruska Federacija
Salamunski Otoci - vidjeti Salomonovi Otoci
Salomonski Otoci - vidjeti Salomonovi Otoci
Salomonovi Otoci - Salomonovi Otoci
Salvador - vidjeti El Salvador
Samoa - Nezavisna Drzava Samoa
San Marino - Republika San Marino
Saudijska Arabija - Kraljevina Saudijska Arabija
Sejseli - Republika Sejseli
Senegal - Republika Senegal
Sijera Leone - Republika Sijera Leone
Singapur - Republika Singapur
Sirija - Sirijska Arapska Republika
Sjedinjene Americke Drzave - Sjedinjene Americke Drzave
Sjeverna Koreja - vidjeti Demokratska Republika Koreja
Slovacka - Slovacka Republika
Slovenija - Republika Slovenija
Solomonovo Otocje - vidjeti Salomonovi Otoci
Solomonski Otoci - vidjeti Salomonovi Otoci
Somalija - Somalijska Republika
Srbija - Republika Srbija
Srednjoafricka Republika - Srednjoafricka Republika
Sudan - Republika Sudan
Surinam - Republika Surinam
Svazi - Kraljevina Svazi
Sveta Lucija - Sveta Lucija
Sveti Kristofor i Nevis - Sveti Kristofor i Nevis
Sveti Toma i Princip - vidjeti Sveti Toma i Prinsipe
Sveti Toma i Prinsipe - Demokratska Republika Sveti Toma i Prinsipe
Sveti Vincent i Grenadini - Sveti Vincent i Grenadini
spanjolska - Kraljevina spanjolska
sri Lanka - Demokratska Socijalisticka Republika sri Lanka
svedska - Kraljevina svedska
svicarska - svicarska Konfederacija
Tadzikistan - Republika Tadzikistan
Tajland - Kraljevina Tajland
Tanzanija - Ujedinjena Republika Tanzanija
Timor-Leste - Demokratska Republika Timor-Leste
Togo - Togoanska Republika
Tonga - Kraljevina Tonga
Trinidad i Tobago - Republika Trinidad i Tobago
Tunis - Republika Tunis
Turkmenistan - Turkmenistan
Turska - Republika Turska
Tuvalu - Tuvalu
Uganda - Republika Uganda
Ujedinjeni Arapski Emirati - Ujedinjeni Arapski Emirati
Ujedinjena Kraljevina - Ujedinjena Kraljevina Velike Britanije i Sjeverne Irske
Ujedinjeno Kraljevstvo v vidjeti Ujedinjena Kraljevina
Ukrajina - Ukrajina
Urugvaj - Istocna Republika Urugvaj
Uzbekistan - Republika Uzbekistan
Vanuatu - Republika Vanuatu
Vatikan - Drzava Vatikanskoga Grada
Velika Britanija - vidjeti Ujedinjena Kraljevina
Venezuela - Bolivarijanska Republika Venezuela
Vijetnam - Socijalisticka Republika Vijetnam
Zair - vidjeti Demokratska Republika Kongo
Zambija - Republika Zambija
Zapadna Samoa - vidjeti Samoa
Zelenortska Republika - vidjeti Kabo Verde
Zimbabve - Republika Zimbabve